{
	"cells": [
		[0,0,0,0,0,0,0,1,1,1,1,1,1,1,1,1,1,1,1],
		[0,0,0,0,0,0,0,1,1,1,1,1,1,1,1,1,1,1,1],
		[0,0,0,0,0,0,0,1,1,1,1,1,1,1,1,1,2,1,1],
		[0,0,0,0,0,0,0,1,1,1,1,1,1,1,1,1,1,1,1],
		[0,0,0,0,0,0,0,1,1,1,1,1,1,1,1,0,2,1,1],
		[0,0,0,0,0,0,0,1,1,2,2,1,2,1,1,1,2,1,1],
		[0,0,0,0,0,0,2,1,1,1,1,1,2,1,1,1,1,1,1],
		[1,1,1,1,1,1,1,1,1,1,1,1,1,1,1,1,1,1,1],
		[1,1,1,1,1,1,1,1,1,1,2,1,1,1,2,2,1,1,1],
		[1,1,1,0,1,1,1,2,1,1,1,2,1,1,1,0,1,1,1],
		[1,1,1,2,2,1,1,1,2,1,1,1,1,1,1,1,1,1,1],
		[1,1,1,1,1,1,1,1,1,1,1,1,1,1,1,1,1,1,1],
		[1,1,1,1,1,1,2,1,1,1,1,1,2,0,0,0,0,0,0],
		[1,1,2,1,1,1,2,1,2,2,1,1,0,0,0,0,0,0,0],
		[1,1,2,0,1,1,1,1,1,1,1,1,0,0,0,0,0,0,0],
		[1,1,1,1,1,1,1,1,1,1,1,1,0,0,0,0,0,0,0],
		[1,1,2,1,1,1,1,1,1,1,1,1,0,0,0,0,0,0,0],
		[0,1,1,1,1,1,1,1,1,1,1,1,0,0,0,0,0,0,0],
		[0,0,1,1,1,1,1,1,1,1,1,1,0,0,0,0,0,0,0]
	],
	"elevation": [
		[0,0,0,0,0,0,0,0,0,0,0,0,0,0,0,0,0,0,0],
		[0,0,0,0,0,0,0,0,0,0,0,0,0,0,0,0,0,0,0],
		[0,0,0,0,0,0,0,0,0,0,0,0,0,0,0,0,1,0,0],
		[0,0,0,0,0,0,0,0,0,0,0,0,0,0,0,0,0,0,0],
		[0,0,0,0,0,0,0,0,0,0,0,0,0,0,0,0,1,0,0],
		[0,0,0,0,0,0,0,0,0,1,1,0,1,0,0,0,1,0,0],
		[0,0,0,0,0,0,1,0,0,0,0,0,1,0,0,0,0,0,0],
		[0,0,0,0,0,0,0,0,0,0,0,0,0,0,0,0,0,0,0],
		[0,0,0,0,0,0,0,0,0,0,1,0,0,0,1,1,0,0,0],
		[0,0,0,0,0,0,0,1,0,0,0,1,0,0,0,0,0,0,0],
		[0,0,0,1,1,0,0,0,1,0,0,0,0,0,0,0,0,0,0],
		[0,0,0,0,0,0,0,0,0,0,0,0,0,0,0,0,0,0,0],
		[0,0,0,0,0,0,1,0,0,0,0,0,1,0,0,0,0,0,0],
		[0,0,1,0,0,0,1,0,1,1,0,0,0,0,0,0,0,0,0],
		[0,0,1,0,0,0,0,0,0,0,0,0,0,0,0,0,0,0,0],
		[0,0,0,0,0,0,0,0,0,0,0,0,0,0,0,0,0,0,0],
		[0,0,1,0,0,0,0,0,0,0,0,0,0,0,0,0,0,0,0],
		[0,0,0,0,0,0,0,0,0,0,0,0,0,0,0,0,0,0,0],
		[0,0,0,0,0,0,0,0,0,0,0,0,0,0,0,0,0,0,0]
	],
	"walkableLos": [
		[0,0,0,0,0,0,0,0,0,0,0,0,0,0,0,0,0,0,0],
		[0,0,0,0,0,0,0,0,0,0,0,0,0,0,0,0,0,0,0],
		[0,0,0,0,0,0,0,0,0,0,0,0,0,0,0,0,0,0,0],
		[0,0,0,0,0,0,0,0,0,0,0,0,0,0,0,0,0,0,0],
		[0,0,0,0,0,0,0,0,0,0,0,0,0,0,0,0,0,0,0],
		[0,0,0,0,0,0,0,0,0,0,0,0,0,0,0,0,0,0,0],
		[0,0,0,0,0,0,0,0,0,0,0,0,0,0,0,0,0,0,0],
		[0,0,0,0,0,0,0,0,0,0,0,0,0,0,0,0,0,0,0],
		[0,0,0,0,0,0,0,0,0,0,0,0,0,0,0,0,0,0,0],
		[0,0,0,0,0,0,0,0,0,0,0,0,0,0,0,0,0,0,0],
		[0,0,0,0,0,0,0,0,0,0,0,0,0,0,0,0,0,0,0],
		[0,0,0,0,0,0,0,0,0,0,0,0,0,0,0,0,0,0,0],
		[0,0,0,0,0,0,0,0,0,0,0,0,0,0,0,0,0,0,0],
		[0,0,0,0,0,0,0,0,0,0,0,0,0,0,0,0,0,0,0],
		[0,0,0,0,0,0,0,0,0,0,0,0,0,0,0,0,0,0,0],
		[0,0,0,0,0,0,0,0,0,0,0,0,0,0,0,0,0,0,0],
		[0,0,0,0,0,0,0,0,0,0,0,0,0,0,0,0,0,0,0],
		[0,0,0,0,0,0,0,0,0,0,0,0,0,0,0,0,0,0,0],
		[0,0,0,0,0,0,0,0,0,0,0,0,0,0,0,0,0,0,0]
	],
	
	"models": [
		{
			"id": 0,
			"model": "null",
			"material": 0
		},
		{
			"id": 1,
			"model": "cube",
			"material": 1
		},
		{
			"id": 2,
			"model": "cube",
			"material": 2
		},
	],
	"materials": [
		{
			"ambient": [ 0.000000,  0.000000,  0.000000], 
			"diffuse": [ 1.000000,  1.000000,  1.000000], 
			"emissive": [ 0.000000,  0.000000,  0.000000], 
			"opacity":  0.000000, 
			"textures": [
				{
					"id": "palette", 
					"filename": "cross.png", 
					"type": "DIFFUSE"
				}
			]
		},
		{
			"ambient": [ 0.000000,  0.000000,  0.000000], 
			"diffuse": [ 1.000000,  1.000000,  1.000000], 
			"emissive": [ 0.000000,  0.000000,  0.000000], 
			"opacity":  0.000000
		}
	]
}