{
	"modelList": [
		{
			"model": "",
			"transform": [],
			"textures": [ "G:/Assets/test/grass512x512.png", "G:/Assets/test/noise512x512.png", "G:/Assets/test/noise512x512.png", "G:/Assets/test/noise512x512.png", "G:/Assets/test/noise512x512.png", "G:/Assets/test/noise512x512.png" ],
			"coordinates": [
				[ 0, 0, 1, 1 ],
				[ 0, 0, 1, 1 ],
				[ 0, 0, 1, 1 ],
				[ 0, 0, 1, 1 ],
				[ 0, 0, 1, 1 ],
				[ 0, 0, 1, 1 ]
			],
			"colorAttributes": [ "ffffffff", "b87d30ff", "b87d30ff", "b87d30ff", "b87d30ff", "b87d30ff" ]
		},
		{
			"model": "",
			"transform": [],
			"textures": [ "G:/Assets/test/glazedTerracotta.png", "G:/Assets/test/glazedTerracotta.png", "G:/Assets/test/glazedTerracotta.png", 
						 "G:/Assets/test/glazedTerracotta.png", "G:/Assets/test/glazedTerracotta.png", "G:/Assets/test/glazedTerracotta.png" ],
			"coordinates": [
				[ 0, 0, 1, 1 ],
				[ 0, 0, 1, 1 ],
				[ 0, 0, 1, 1 ],
				[ 0, 0, 1, 1 ],
				[ 0, 0, 1, 1 ],
				[ 0, 0, 1, 1 ]
			],
			"colorAttributes": [ "ffffffff", "ffffffff", "ffffffff", "ffffffff", "ffffffff", "ffffffff" ]
		},
		{
			"model": "res/models/decor/cube.obj",
			"transform":[
				[ 0.50f, 0.00f, 2.25f ], 
				[ 0.00f, 0.00f, 0.00f ], 
				[ 1f, 1f, 0.5f ],
			],
			"textures": [],
			"coordinates": [],
			"colorAttributes": [ "ffffffff" ]
		},
		{
			"model": "res/models/decor/cube.obj",
			"transform":[
				[ 0.50f, 0.00f, 2.25f ], 
				[ 0.00f, 0.00f, 0.00f ], 
				[ 1f, 2f, 0.5f ],
			],
			"textures": [],
			"coordinates": [],
			"colorAttributes": [ "ffffffff" ]
		},
		{
			"model": "res/models/decor/cube.obj",
			"transform":[
				[ 1.00f, 0.00f, 2.25f ], 
				[ 0.00f, 0.00f, 0.00f ], 
				[ 2f, 1f, 0.5f ],
			],
			"textures": [],
			"coordinates": [],
			"colorAttributes": [ "ffffffff" ]
		},
		{
			"model": "res/models/decor/pinetree.obj",
			"transform":[
				[ 0.5f, 0.5f, 2.00f ], 
				[ 1.00f, 0.00f, 0.00f ], 
				[ 0.13f, 0.13f, 0.13f ],
			],
			"colorAttributes": [ "ffffffff" ]
		},
		{
			"model": "",
			"transform":[
				[ -10.00f, -10.00f, -1.0f ], 
				[ 0.00f, 0.00f, 0.00f ], 
				[ 1f, 1f, 0.5f ],
			],
			"textures": [ "G:/Assets/test/pix.png", "G:/Assets/test/pix.png", "G:/Assets/test/pix.png", "G:/Assets/test/pix.png", "G:/Assets/test/pix.png", "G:/Assets/test/pix.png" ],
			"coordinates": [
				[ 0, 0, 1, 1 ],
				[ 0, 0, 1, 1 ],
				[ 0, 0, 1, 1 ],
				[ 0, 0, 1, 1 ],
				[ 0, 0, 1, 1 ],
				[ 0, 0, 1, 1 ]
			],
			"colorAttributes": [ "4f4f4fff", "4f4f4fff", "4f4f4fff", "4f4f4fff", "4f4f4fff", "4f4f4fff" ]
		}
	],
	"decorations": [
		{
			"model": "res/models/decor/pinetree.obj",
			"transform":[
				[ 0.5f, 0.5f, 1f ], 
				[ 1.00f, 0.00f, 0.00f ], 
				[ 0.13f, 0.13f, 0.13f ],
			],
			"colorAttributes": [ "ffffffff" ]
		}
	],
	"layer0Models": [
		[7,7,7,7,7,7,7,7,7,7,7,7,7,7,7,7,7,7,7,7,7,7,7,7,7,7,7,7,7,7,7,7,7,7,7,7,7,7,7,7],
		[7,7,7,7,7,7,7,7,7,7,7,7,7,7,7,7,7,7,7,7,7,7,7,7,7,7,7,7,7,7,7,7,7,7,7,7,7,7,7,7],
		[7,7,7,7,7,7,7,7,7,7,7,7,7,7,7,7,7,7,7,7,7,7,7,7,7,7,7,7,7,7,7,7,7,7,7,7,7,7,7,7],
		[7,7,7,7,7,7,7,7,7,7,7,7,7,7,7,7,7,7,7,7,7,7,7,7,7,7,7,7,7,7,7,7,7,7,7,7,7,7,7,7],
		[7,7,7,7,7,7,7,7,7,7,7,7,7,7,7,7,7,7,7,7,7,7,7,7,7,7,7,7,7,7,7,7,7,7,7,7,7,7,7,7],
		[7,7,7,7,7,7,7,7,7,7,7,7,7,7,7,7,7,7,7,7,7,7,7,7,7,7,7,7,7,7,7,7,7,7,7,7,7,7,7,7],
		[7,7,7,7,7,7,7,7,7,7,7,7,7,7,7,7,7,7,7,7,7,7,7,7,7,7,7,7,7,7,7,7,7,7,7,7,7,7,7,7],
		[7,7,7,7,7,7,7,7,7,7,7,7,7,7,7,7,7,7,7,7,7,7,7,7,7,7,7,7,7,7,7,7,7,7,7,7,7,7,7,7],
		[7,7,7,7,7,7,7,7,7,7,7,7,7,7,7,7,7,7,7,7,7,7,7,7,7,7,7,7,7,7,7,7,7,7,7,7,7,7,7,7],
		[7,7,7,7,7,7,7,7,7,7,7,7,7,7,7,7,7,7,7,7,7,7,7,7,7,7,7,7,7,7,7,7,7,7,7,7,7,7,7,7],
		[7,7,7,7,7,7,7,7,7,7,7,7,7,7,7,7,7,7,7,7,7,7,7,7,7,7,7,7,7,7,7,7,7,7,7,7,7,7,7,7],
		[7,7,7,7,7,7,7,7,7,7,7,7,7,7,7,7,7,7,7,7,7,7,7,7,7,7,7,7,7,7,7,7,7,7,7,7,7,7,7,7],
		[7,7,7,7,7,7,7,7,7,7,7,7,7,7,7,7,7,7,7,7,7,7,7,7,7,7,7,7,7,7,7,7,7,7,7,7,7,7,7,7],
		[7,7,7,7,7,7,7,7,7,7,7,7,7,7,7,7,7,7,7,7,7,7,7,7,7,7,7,7,7,7,7,7,7,7,7,7,7,7,7,7],
		[7,7,7,7,7,7,7,7,7,7,7,7,7,7,7,7,7,7,7,7,7,7,7,7,7,7,7,7,7,7,7,7,7,7,7,7,7,7,7,7],
		[7,7,7,7,7,7,7,7,7,7,7,7,7,7,7,7,7,7,7,7,7,7,7,7,7,7,7,7,7,7,7,7,7,7,7,7,7,7,7,7],
		[7,7,7,7,7,7,7,7,7,7,7,7,7,7,7,7,7,7,7,7,7,7,7,7,7,7,7,7,7,7,7,7,7,7,7,7,7,7,7,7],
		[7,7,7,7,7,7,7,7,7,7,7,7,7,7,7,7,7,7,7,7,7,7,7,7,7,7,7,7,7,7,7,7,7,7,7,7,7,7,7,7],
		[7,7,7,7,7,7,7,7,7,7,7,7,7,7,7,7,7,7,7,7,7,7,7,7,7,7,7,7,7,7,7,7,7,7,7,7,7,7,7,7],
		[7,7,7,7,7,7,7,7,7,7,7,7,7,7,7,7,7,7,7,7,7,7,7,7,7,7,7,7,7,7,7,7,7,7,7,7,7,7,7,7],
		[7,7,7,7,7,7,7,7,7,7,7,7,7,7,7,7,7,7,7,7,7,7,7,7,7,7,7,7,7,7,7,7,7,7,7,7,7,7,7,7],
		[7,7,7,7,7,7,7,7,7,7,7,7,7,7,7,7,7,7,7,7,7,7,7,7,7,7,7,7,7,7,7,7,7,7,7,7,7,7,7,7],
		[7,7,7,7,7,7,7,7,7,7,7,7,7,7,7,7,7,7,7,7,7,7,7,7,7,7,7,7,7,7,7,7,7,7,7,7,7,7,7,7],
		[7,7,7,7,7,7,7,7,7,7,7,7,7,7,7,7,7,7,7,7,7,7,7,7,7,7,7,7,7,7,7,7,7,7,7,7,7,7,7,7],
		[7,7,7,7,7,7,7,7,7,7,7,7,7,7,7,7,7,7,7,7,7,7,7,7,7,7,7,7,7,7,7,7,7,7,7,7,7,7,7,7],
		[7,7,7,7,7,7,7,7,7,7,7,7,7,7,7,7,7,7,7,7,7,7,7,7,7,7,7,7,7,7,7,7,7,7,7,7,7,7,7,7],
		[7,7,7,7,7,7,7,7,7,7,7,7,7,7,7,7,7,7,7,7,7,7,7,7,7,7,7,7,7,7,7,7,7,7,7,7,7,7,7,7],
		[7,7,7,7,7,7,7,7,7,7,7,7,7,7,7,7,7,7,7,7,7,7,7,7,7,7,7,7,7,7,7,7,7,7,7,7,7,7,7,7],
		[7,7,7,7,7,7,7,7,7,7,7,7,7,7,7,7,7,7,7,7,7,7,7,7,7,7,7,7,7,7,7,7,7,7,7,7,7,7,7,7],
		[7,7,7,7,7,7,7,7,7,7,7,7,7,7,7,7,7,7,7,7,7,7,7,7,7,7,7,7,7,7,7,7,7,7,7,7,7,7,7,7],
		[7,7,7,7,7,7,7,7,7,7,7,7,7,7,7,7,7,7,7,7,7,7,7,7,7,7,7,7,7,7,7,7,7,7,7,7,7,7,7,7],
		[7,7,7,7,7,7,7,7,7,7,7,7,7,7,7,7,7,7,7,7,7,7,7,7,7,7,7,7,7,7,7,7,7,7,7,7,7,7,7,7],
		[7,7,7,7,7,7,7,7,7,7,7,7,7,7,7,7,7,7,7,7,7,7,7,7,7,7,7,7,7,7,7,7,7,7,7,7,7,7,7,7],
		[7,7,7,7,7,7,7,7,7,7,7,7,7,7,7,7,7,7,7,7,7,7,7,7,7,7,7,7,7,7,7,7,7,7,7,7,7,7,7,7],
		[7,7,7,7,7,7,7,7,7,7,7,7,7,7,7,7,7,7,7,7,7,7,7,7,7,7,7,7,7,7,7,7,7,7,7,7,7,7,7,7],
		[7,7,7,7,7,7,7,7,7,7,7,7,7,7,7,7,7,7,7,7,7,7,7,7,7,7,7,7,7,7,7,7,7,7,7,7,7,7,7,7],
		[7,7,7,7,7,7,7,7,7,7,7,7,7,7,7,7,7,7,7,7,7,7,7,7,7,7,7,7,7,7,7,7,7,7,7,7,7,7,7,7],
		[7,7,7,7,7,7,7,7,7,7,7,7,7,7,7,7,7,7,7,7,7,7,7,7,7,7,7,7,7,7,7,7,7,7,7,7,7,7,7,7],
		[7,7,7,7,7,7,7,7,7,7,7,7,7,7,7,7,7,7,7,7,7,7,7,7,7,7,7,7,7,7,7,7,7,7,7,7,7,7,7,7],
		[7,7,7,7,7,7,7,7,7,7,7,7,7,7,7,7,7,7,7,7,7,7,7,7,7,7,7,7,7,7,7,7,7,7,7,7,7,7,7,7]
	],
	"cellModels": [
		[0,0,0,0,0,0,0,0,1,1,1,1,1,1,1,1,1,1,1],
		[0,0,0,0,0,0,0,1,1,1,1,1,1,1,1,1,1,1,1],
		[0,0,0,0,0,0,0,1,1,1,1,1,1,1,1,1,1,1,1],
		[0,0,0,0,0,0,0,1,1,1,1,1,1,1,1,1,1,1,1],
		[0,0,0,0,0,0,0,1,1,1,1,1,1,1,1,0,1,1,1],
		[0,0,0,0,0,0,0,1,1,1,1,1,1,1,1,1,1,1,1],
		[0,0,0,0,0,0,1,1,1,1,1,1,1,1,1,1,1,1,1],
		[0,1,1,1,1,1,1,1,1,1,1,1,1,1,1,1,1,1,1],
		[1,1,1,1,1,1,1,1,1,1,1,1,1,1,1,1,1,1,1],
		[1,1,1,0,1,1,1,1,1,1,1,1,1,1,1,0,1,1,1],
		[1,1,1,1,1,1,1,1,1,1,1,1,1,1,1,1,1,1,1],
		[1,1,1,1,1,1,1,1,1,1,1,1,1,1,1,1,1,1,0],
		[1,1,1,1,1,1,1,1,1,1,1,1,1,0,0,0,0,0,0],
		[1,1,1,1,1,1,1,1,1,1,1,1,0,0,0,0,0,0,0],
		[1,1,1,0,1,1,1,1,1,1,1,1,0,0,0,0,0,0,0],
		[1,1,1,1,1,1,1,1,1,1,1,1,0,0,0,0,0,0,0],
		[1,1,1,1,1,1,1,1,1,1,1,1,0,0,0,0,0,0,0],
		[1,1,1,1,1,1,1,1,1,1,1,1,0,0,0,0,0,0,0],
		[1,1,1,1,1,1,1,1,1,1,1,0,0,0,0,0,0,0,0]
	],
	"layer2Models": [
		[0,0,0,0,0,0,0,0,0,0,0,0,0,0,0,0,0,0,0],
		[0,0,0,0,0,0,0,0,0,0,0,0,0,0,0,0,0,0,0],
		[0,0,0,0,0,0,0,0,0,0,0,0,0,0,0,0,3,0,0],
		[0,0,0,0,0,0,0,0,0,0,0,0,0,0,0,0,0,0,0],
		[0,0,0,0,0,0,0,0,0,0,0,0,0,0,0,0,5,0,0],
		[0,0,0,0,0,0,0,0,0,4,0,0,5,0,0,0,0,0,0],
		[0,0,0,0,0,0,3,0,0,0,0,0,0,0,0,0,0,0,0],
		[0,0,0,0,0,0,0,0,0,0,0,0,0,0,0,0,0,0,0],
		[0,0,0,0,0,0,0,0,0,0,6,0,0,0,4,0,0,0,0],
		[0,0,0,0,0,0,0,6,0,0,0,6,0,0,0,0,0,0,0],
		[0,0,0,4,0,0,0,0,6,0,0,0,0,0,0,0,0,0,0],
		[0,0,0,0,0,0,0,0,0,0,0,0,0,0,0,0,0,0,0],
		[0,0,0,0,0,0,5,0,0,0,0,0,3,0,0,0,0,0,0],
		[0,0,5,0,0,0,0,0,4,0,0,0,0,0,0,0,0,0,0],
		[0,0,0,0,0,0,0,0,0,0,0,0,0,0,0,0,0,0,0],
		[0,0,0,0,0,0,0,0,0,0,0,0,0,0,0,0,0,0,0],
		[0,0,3,0,0,0,0,0,0,0,0,0,0,0,0,0,0,0,0],
		[0,0,0,0,0,0,0,0,0,0,0,0,0,0,0,0,0,0,0],
		[0,0,0,0,0,0,0,0,0,0,0,0,0,0,0,0,0,0,0]
	],
	"cellTypes": [
		[01,01,01,01,01,01,01,01,00,00,00,00,00,00,00,00,00,00,01],
		[01,01,01,01,01,01,01,00,00,00,00,00,00,00,00,00,00,00,00],
		[01,01,01,01,01,01,01,00,00,00,00,00,00,00,00,00,15,00,00],
		[01,01,01,01,01,01,01,00,00,00,00,00,00,00,00,00,00,00,00],
		[01,01,01,01,01,01,01,00,00,00,00,00,00,00,00,01,15,00,00],
		[01,01,01,01,01,01,01,00,00,15,15,00,15,00,00,00,15,00,00],
		[01,01,01,01,01,01,15,00,00,00,00,00,15,00,00,00,00,00,00],
		[01,00,00,00,00,00,00,00,00,00,00,00,00,00,00,00,00,00,00],
		[00,00,00,00,00,00,00,00,00,00,15,00,00,00,15,15,00,00,00],
		[00,00,00,01,00,00,00,15,00,00,00,15,00,00,00,01,00,00,00],
		[00,00,00,15,15,00,00,00,15,00,00,00,00,00,00,00,00,00,00],
		[00,00,00,00,00,00,00,00,00,00,00,00,00,00,00,00,00,00,01],
		[00,00,00,00,00,00,15,00,00,00,00,00,15,01,01,01,01,01,01],
		[00,00,15,00,00,00,15,00,15,15,00,00,01,01,01,01,01,01,01],
		[00,00,15,01,00,00,00,00,00,00,00,00,01,01,01,01,01,01,01],
		[00,00,00,00,00,00,00,00,00,00,00,00,01,01,01,01,01,01,01],
		[00,00,15,00,00,00,00,00,00,00,00,00,01,01,01,01,01,01,01],
		[00,00,00,00,00,00,00,00,00,00,00,00,01,01,01,01,01,01,01],
		[01,00,00,00,00,00,00,00,00,00,00,01,01,01,01,01,01,01,01]
	]

}